1111111111111
1110111110111
1111011101111
111C00P00C111
1100100010011
1000000000001
101000E000101
1010111110101
1C110010011C1
1111111111111
