1111111111111111111111111
10001P0010110001011010001
1010101010110101011010101
1010101010110001001010101
1001101010110101010010101
1010101010110101011010101
101010001000C101011010001
111111C111110101111111111
1111110111110101111111111
11111100000001C000000E001
1111111111111111111111111
