1111111111111
1110111110111
1111011101111
111000P000111
1100100010011
100000C000001
101000E000101
1010111110111
10110010011C1
1111111111111
