1111111111111
111000P000111
100000C000000
101000E000101
1111111111111
