11111111111111111111111111
11101111101111110111110111
1111C111C11111111011101111
111000P0001111110000000111
11001000100111100100010011
1C000000000C11000000000001
101000E0001011010000000101
10101111101011010111110101
10110010011011011001001101
11111111111111111111111111
