1111111111111
1110111110111
1111011101111
111000P000111
110010C010011
1000000000001
101000E000101
1010111110101
1111001001111
1111111111111
