111111111111111
10P0E0C0C000C01
111111111111111
