111111111111111
10P0E0C0C000001
111111111111111
