111111111
10P0E0C01
111111111
