11111111111
10000001101
10001010101
1ECP1000001
11111111111
10000010111
11111111111
