1111111111111111111111
1110111110111111001111
1111C111C1111110000111
111000P000111100000011
1100100010011001001001
1C000000000C1000000001
101000E000101110110111
1010111110101101001011
1011001001101010110101
1111111111111111111111
