1111111111111111111111111
1110111110111110111110111
1111C111C1111011011101101
111000P000111010000000101
1100100010011000100010001
1C000000000C1000000000001
101000E000101100000000011
1010111110101110111110111
1011001001100000111110011
1111111111111111111111111
