11111111111111111111111
11101111101111111111111
1111C111C11111111111111
111000P0001111111111111
11001000100111111111111
1C000000000C11111111111
101000E0001010111110101
10101111101011011101101
10110010011010000000101
11111111111000100010001
11111111111000000000001
11111111111100000000011
11111111111110111110111
11111111111000111110011
11111111111111111111111
