1111111111111  1
1110111110111  1
1111C111C1111  1
111000P000111  1
1100100010011  1
1C000000000C1  1
101000E000101  1
1010111110101  1
1011001001101  1
1111111111111  1
