11111111111
1P00000C101
100C1010101
1E0C1000001
11111111111
10000001011
11111111111
