11111
1P0C1
1C0C1
1E0C1
11111
